###############
#b#p..........#
#.####r##r#...#
#.............#
###.####f##.###
#p#r....p#.h..#
#......###....#
######h..#....#
###r##...#..#.#
#p.......#.h..#
###.##.###..#p#
#h.....#r...###
#####.##.##..##
#@...........##
###############