###############
#........h.##.#
#p#.##.#......#
########....#.#
########.h..#@#
#p#r#..#....#f#
#.#.#.r#....#p#
#...........#.#
#####.###...#.#
#...#.fg#.h...#
#.#...###.....#
#.#####b###.###
#.#...#.#.#.#p#
#...#p#..h....#
###############