###############
#ph.......#...#
#.##.###..###.#
#..#####..#bf.#
#r##......###.#
#..#..........#
#.##..#.#..####
#.##..#.#....r#
#....#.h.#.##.#
#.....#p#..##.#
####..###..#..#
#.....#@#..##.#
#....##.##.##.#
#p.#...h...#p.#
###############